111111111111111111111111111111111111111111111111111
100000000000101000101010000010001000000000100000101
111111101010101011101011101010111011101110111110101
100010001010000000100010101010001010000010101010101
101011101111111010111010101010111011111011101010101
101000000010000010101000101000000000100010000010001
111111111111111011101010111010101111101010111110111
100010100000101010001010001010101010001010101000001
101010111011101011101011111011101010111110101111101
101000100000100000000000000000101000000010000010001
111011111110111011101111111011101111111010101110111
100000100000100000100000101010000000100010100000001
111010101110111111111110101111101010111011101011101
100010001000001000000000001000001010100010001010101
111010101111101111101111111011111111101110111010111
101010101010001000000010000010100000000000101000001
101011111010101110111111111110101010111111101111101
100000001010100010100000000010101010101000101000001
111011111011101010111111101110101011101010101010111
101000100000001010101010100000001010100010001010001
101111111110111110101010101110111110101011101011111
100000101010101000000010101000001000001000101010001
101111101010101011111010101110111010111110111010111
101010001010101000001000101010100010001010100000101
101010101010101011111111101010101011111011111011101
100000100010101000000010101000101000000000001000001
101110101110101011111110111011111111111111101010101
101010100000101010000000000010001010001010101010101
101010111010101110101010101011101010101010101110111
100010001010101000101010101010000010100000001000001
101011111110101111101111111110101111111011101010111
101010000010100010101010000010100000000010000010101
111111101010111010111011111010111011101111111110101
101000001010000000000000000000001010000010001010101
101011111011101011111011101111111110111110111011101
100000001000101010001010101000101010000010001000101
111011111111101110101010111110101010111110111010101
100000000000001010100010100000000010001000001010101
111011111110101011111110111011111111101110101010101
100010001010100000100000001010100000001000101010001
111111101010111011101110101010111111111111101011111
100000100010101000101010101000101000101000100010001
111110111011101110101011111110101011101010101011101
100000000010000010000000000000000000000010001010101
111110111111111010101111111110101110111111111110101
101000100000000010100000001010101010101010000000001
101110111011111011101110111010111010101011111011111
101000000000001000001000000010101010000000000010001
101011111111101011111011111011101011111010111110111
100000000000101010000000001000000000100010000000001
111111111111111111111111111111111111111111111111111
