111111111111111111111111111111111111111111111111111
100000000010000000000010100010000010000010000000001
111110111110111010111010101111101111101110111111101
100000000010100010100000000000000010000000001010001
101011111010111111101111111110111110101010101010111
101000100000000010100010000000000000101010101000001
101111101111111110101111111111101111111110111111101
101010000000100000100010000010000010001010101010101
101011111110101110101110111011101111101011101010101
101000000010101010001000001010000000000000001000001
111011101110101011101110101011101111111011111110111
100010001010100000101000101000000010001000000010101
111110101010111111101111111111111011101111101011101
100010101000100010100000000000001000001000001000001
111010111010111010111111111011111011111111111111101
100000000010100000000000000010000010001000001010101
111010111110111010101110101110101110101110111010101
100010100010001010101000101010100000101000100010001
101010111010101011111011101011101110111110101010111
101010100000101000101000100000100010001000001010001
111011111010111110101111111011111110111110111010101
101000100010100000100010101010001000001010101010101
101110111111111011101110101011101110101011101010111
101000000010001010001010001000100010100010101000001
101010111011101010111011101111101111111110101011111
101010001000001000100010100000100000101000001010001
101111111111101110101010111110111110101011111010111
101010100000000010001010001000001010001000100000001
101010101011101011111110111011111011101010111110111
100000101000101000001000000000100000000010100010001
101011101111111111111111111011111011101110101110111
101000000010001000100010001010001000101000001000101
111111111010101011111010101011101011111111101110101
100000000000100010000010100000100010000010100010001
111110111011111111111011101111101110111010111011101
100000101010000000100000001000000000101010001000101
101011101010101010101010111110111110101111101010101
101000001010101010101010000000000010100000100010101
101011101110111011101010111110111010101111101011111
101010100000100010001010000010101010000010101000001
101110101111101111101111101110101011111010101110101
100010001010001000000010000010001000001010001010101
101111111010111010111010111111111011101111111010111
101000001010101010101010100000101000101000001000001
111011101010101010101110101010101110111011111011101
100010001010000010100000101010000010100000100010001
101110111011101110111111101110101110101011101010111
100010101000000010000010001010101010001000101010101
111010101011101110111110111010101011101110101111101
100010000000101000000000001000100010000010100000001
111111111111111111111111111111111111111111111111111
