11111111111
10100010101
10111010101
10000010001
11111011101
10000010001
10111111101
10100000001
10101111101
10000010001
11111111111
