██████████████████████████████████████████████████████████████████████████████████████████████████████
██      ██          ██      ██  ██              ██  ██              ██      ██      ██  ██  ██      ██
██  ██████  ██████  ██████  ██  ██  ██████████  ██  ██████  ██████  ██████  ██  ██  ██  ██  ██  ██████
██      ██  ██  ██  ██  ██      ██  ██      ██  ██  ██  ██      ██  ██          ██                  ██
██  ██████  ██  ██  ██  ██  ██  ██  ██  ██████████  ██  ██████  ██  ██  ██████  ██████████████████  ██
██  ██      ██              ██          ██                  ██  ██          ██      ██  ██  ██  ██  ██
██  ██████  ██████████  ██████  ██████  ██  ██  ██  ██████  ██  ██████████████████████  ██  ██  ██  ██
██  ██          ██  ██      ██  ██          ██  ██      ██          ██                  ██          ██
██  ██  ██████  ██  ██████████  ██████  ██████  ██  ██████  ██████████████████  ██████  ██  ██████████
██      ██  ██  ██  ██              ██  ██      ██      ██  ██      ██      ██      ██  ██      ██  ██
██  ██████  ██████  ██████  ██████████████████████████████████████  ██████  ██  ██████████  ██  ██  ██
██                  ██      ██              ██          ██          ██  ██  ██          ██  ██      ██
██████████████████████████  ██  ██████████  ██████████  ██████  ██  ██  ██  ██  ██████████████████  ██
██      ██  ██      ██          ██          ██              ██  ██          ██          ██          ██
██  ██████  ██████  ██  ██  ██████  ██████████  ██  ██  ██████  ██████████  ██████  ██  ██████████  ██
██      ██              ██  ██              ██  ██  ██  ██  ██  ██          ██      ██      ██  ██  ██
██  ██  ██████████████████  ██████████  ██████████████  ██  ██████████████  ██████████  ██████  ██  ██
██  ██      ██  ██  ██      ██      ██                  ██              ██          ██  ██      ██  ██
██  ██████  ██  ██  ██  ██  ██████  ██████  ██  ██  ██  ██████  ██████████████  ██████  ██  ██  ██  ██
██  ██  ██  ██          ██          ██      ██  ██  ██          ██  ██      ██  ██          ██      ██
██████  ██  ██  ██  ██████  ██████  ██████████████  ██████████  ██  ██  ██████  ██████████  ██  ██  ██
██              ██      ██      ██      ██      ██  ██      ██  ██  ██                      ██  ██  ██
██  ██████  ██  ██  ██  ██████  ██████████  ██████████  ██  ██████  ██████  ██████  ██  ██████  ██  ██
██  ██      ██  ██  ██  ██  ██  ██                      ██  ██          ██  ██  ██  ██  ██  ██  ██  ██
██████████████████  ██  ██  ██  ██  ██  ██████████████████  ██████████  ██████  ██  ██████  ██████  ██
██          ██      ██  ██      ██  ██          ██      ██  ██  ██  ██  ██      ██          ██      ██
██  ██████  ██████  ██████████  ██  ██████████████████  ██  ██  ██  ██  ██  ██████████  ██████  ██████
██      ██              ██  ██  ██  ██      ██  ██      ██  ██      ██              ██      ██  ██  ██
██  ██  ██████████████  ██  ██  ██  ██  ██  ██  ██  ██████  ██  ██  ██████████████  ██████  ██  ██  ██
██  ██  ██          ██  ██  ██          ██      ██              ██              ██      ██  ██  ██  ██
██████  ██  ██  ██████████  ██  ██  ██████  ██████████████████████████████████  ██████  ██  ██  ██  ██
██          ██      ██      ██  ██  ██          ██      ██      ██                      ██  ██      ██
██  ██  ██████████  ██  ██  ██  ██████████  ██  ██  ██████  ██  ██  ██████████  ██████████████████  ██
██  ██      ██      ██  ██      ██  ██      ██  ██          ██      ██                  ██          ██
██████  ██  ██  ██████████████  ██  ██████████  ██████  ██████████  ██  ██████████████  ██████  ██████
██      ██  ██          ██  ██  ██                  ██  ██  ██      ██  ██      ██      ██          ██
██  ██████████████████████  ██████████████  ██████  ██████  ██████████  ██  ██████  ██  ██████████  ██
██      ██  ██      ██                  ██  ██                  ██      ██      ██  ██  ██          ██
██  ██  ██  ██  ██████  ██  ██████████████  ██  ██  ██████  ██  ██████  ██████  ██████  ██████████████
██  ██      ██      ██  ██  ██  ██          ██  ██      ██  ██  ██      ██          ██  ██  ██      ██
██  ██████████████  ██  ██████  ██████  ██████  ██  ██████  ██████  ██████  ██████████  ██  ██████  ██
██  ██      ██  ██      ██      ██          ██  ██      ██      ██  ██  ██                      ██  ██
██  ██  ██████  ██  ██████  ██  ██  ██████████  ██████████  ██████████  ██████████████  ██████████  ██
██      ██          ██      ██  ██  ██      ██  ██  ██      ██          ██      ██  ██  ██          ██
██████  ██████  ██████  ██████  ██  ██████  ██████  ██████████████████  ██  ██  ██  ██  ██  ██  ██  ██
██                      ██      ██      ██  ██  ██                  ██  ██  ██      ██      ██  ██  ██
██  ██████  ██████████  ██████  ██████  ██  ██  ██████  ██████  ██  ██  ██  ██  ██  ██████████  ██████
██      ██  ██              ██      ██          ██          ██  ██  ██      ██  ██              ██  ██
██  ██████████████  ██████████  ██████████████  ██████  ██████████████████████  ██  ██████  ██████  ██
██          ██      ██                  ██                  ██                  ██  ██              ██
██████████████████████████████████████████████████████████████████████████████████████████████████████
