██████████████████████
██  ██              ██
██  ██  ██████████████
██                  ██
██████  ██████████  ██
██      ██      ██  ██
██  ██  ██████  ██  ██
██  ██  ██          ██
██████  ██████  ██████
██          ██      ██
██████████████████████
