█████████████████████████████████████████████████████████████████████████████████████████████████████
█   █             █   █       █ █           █ █     █     █ █           █   █   █   █           █   █
█ ███████ ███████ ███ █████ █ █ ███ ███ █ ███ ███ █ ███ █ █ █ █ █ ███ ███ █████ █ █████████████ █ █ █
█               █ █         █ █     █   █   █   █ █   █ █ █   █ █ █ █   █   █   █         █ █ █ █ █ █
█ █ ███████ ███ █ █ █ ███ █████████ ███ ███ ███ ███ ███ ███████████ ███ █ ███ ███ █ █████ █ █ █ ███ █
█ █     █   █   █ █ █ █ █   █     █ █ █   █ █       █ █     █ █           █ █     █ █     █         █
█████ █████ █ ███ █ ███ ███████ █ ███ █ █ ███ ███ ███ █ █████ █████ █████ █ █████ █████████ █ █████ █
█       █ █ █   █       █ █   █ █ █     █ █ █   █ █       █ █ █   █     █         █   █   █ █     █ █
███ █████ █████ █████████ █ ███ ███ █████ █ █ ███████ █████ █ █ ███ █ ███ ███ █ ███ █ ███ █ ███ ███ █
█   █     █   █   █   █ █   █       █         █ █           █ █   █ █   █ █ █ █     █   █     █ █   █
█ ███ █████ █ █ █ █ █ █ ███ █ ███ █ █ ███ ███ █ ███ ███ █████ ███ █████ ███ ███ ███ ███ █ █ ███ ███ █
█ █     █   █ █ █ █ █   █   █ █   █ █   █ █ █       █ █ █ █ █   █   █ █ █   █     █ █     █ █   █ █ █
█ ███ ███████ ███ █████ █ ███ █ █ █ ███ ███ ███ █ ███ ███ █ ███ █ █ █ █ ███ ███ ███████ █████ ███ █ █
█     █ █   █     █ █       █ █ █ █ █         █ █     █ █ █     █ █ █ █ █   █ █   █ █   █   █   █ █ █
███ ███ █ ███ █ ███ ███ █ ███████ █ ███ ███ ███████████ █ ███ █████ █ █ ███ █ █████ █████ ███ ███ █ █
█   █       █ █     █ █ █ █   █   █   █ █         █ █     █   █   █         █     █   █ █     █ █   █
█ █ ███████ █ █ █ ███ ███ █ █ █ █████████████ █ ███ █ ███ █ ███ ███ █ █ █ ███ ███ ███ █ ███ █ █ ███ █
█ █   █   █   █ █     █ █ █ █ █ █       █ █ █ █ █ █ █   █   █       █ █ █ █     █   █ █     █ █ █ █ █
█ ███ █ █ ███ ███ █████ █ █ ███ █ ███████ █ █ █ █ █ █ █ ███ █ █ ███ █ ███ █ ███████ █ █ ███████ █ █ █
█   █ █ █       █ █ █ █   █   █       █ █ █   █   █ █ █   █ █ █ █ █ █   █ █ █       █   █ █   █ █   █
███████ ███ ███████ █ █ █ █ ███ █████ █ █ ███ █ ███ █████ █ █ █ █ █ █ █ █████ █ ███ ███ █ ███ █ █████
█       █     █ █     █ █ █ █ █ █   █ █     █ █   █ █     █   █ █   █ █ █     █ █     █       █ █   █
█ █ █████ █████ █ ███████ █ █ █ ███ █ █████ ███ ███ ███████ ███ ███████ █████ █ █ ███ █ █ █ ███ █ ███
█ █ █ █   █       █     █   █     █ █ █ █   █     █ █ █     █ █ █ █ █   █     █ █   █ █ █ █       █ █
█ █ █ █ █████ ███ █ █ ███ █ █ ███ █ ███ █ █ ███ ███ █ ███ ███ █ █ █ ███ █ ███████████████████ █████ █
█ █   █   █   █     █ █   █   █   █       █ █   █   █ █     █   █   █ █   █   █ █ █ █     █         █
█ █ █ █████ █ █████ █ ███ ███ █ ███████ ███████ █ █ █ █ █ ███████ ███ █████ ███ █ █ █ ███████ ███ ███
█ █ █   █   █ █     █ █     █ █ █   █   █     █   █   █ █           █   █   █ █ █ █ █           █ █ █
█ ███████████████ █ █ █ █████ █ █ ███ █ █ ███ █████████ █████ █ ███ ███ █ ███ █ █ █ █████████ █████ █
█       █ █ █     █ █ █ █   █ █     █ █   █   █   █   █ █   █ █   █ █     █     █       █ █ █ █     █
███ ███ █ █ ███████ █████ █ █ █████ ███ █████ █ █ █ █████ █████ █████████ █ █ █████ █████ █ █████ ███
█ █ █       █         █   █ █   █   █   █   █ █ █   █                 █   █ █       █ █   █         █
█ █ █████ ███████████ █ ███████ █ █████ █ ███ █████ ███ ███ █████████ ███ ███ █ █████ ███ █████████ █
█ █ █ █ █       █ █   █     █   █     █ █ █ █     █   █ █       █     █       █     █     █         █
█ █ █ █ ███ █████ █ █ █ █████ █ █ █ █ ███ █ █ █ ███ ███ █████ █ ███████ █ █████ ███████ ███ █████ █ █
█     █ █     █     █ █ █   █ █ █ █ █   █     █ █   █       █ █         █ █   █   █ █       █ █   █ █
███ ███ █ █ ███ █████ █ ███ █ █ █ █ █ ███ █ █ ███ ███ ███████████████ ███ ███ █████ █ █████ █ █ █ █ █
█       █ █     █       █ █   █ █ █ █ █   █ █     █   █ █ █           █ █           █   █ █ █   █ █ █
█ ███ ███ █████ █ █████ █ █ ███ █████ ███ ███████ █████ █ █ ███ █ █████ █ █ █ █████ █ ███ ███ ███ ███
█   █   █   █   █ █   █ █ █ █ █   █   █   █               █   █ █   █ █ █ █ █ █     █ █   █   █     █
█████ █████ █ █ ███ █ █ █ ███ █ █ ███ ███████ ███████ ███ █ █████ █ █ █ █ █████ ███ █ ███ █ ███ █████
█     █   █ █ █ █ █ █       █   █   █   █     █     █   █   █ █ █ █ █         █   █   █   █ █   █   █
█ █ █████ ███████ █████ █████ █ ███████ █████████ ███ ███ ███ █ █████████ █████████████ ███ ███ ███ █
█ █       █     █   █         █     █       █ █   █ █ █           █     █   █       █ █   █   █     █
███ █████ █ ███████ █████████ ███████ ███ ███ █ ███ █ █████ ███████ █ █ ███ ███ █████ ███ ███████ █ █
█     █     █   █     █ █   █   █ █   █     █ █ █   █     █     █   █ █ █ █ █ █     █   █ █ █ █ █ █ █
█ █████ █████ █ ███ ███ █ █████ █ █ █████████ █ ███ █ █████ █████ █ █████ █ █ █ ███████ █ █ █ █ █ ███
█     █ █ █   █   █ █ █   █     █ █   █               █   █   █ █ █   █     █         █     █       █
███████ █ ███ █ █ █ █ █ █ █ █████ █ ███ ███████████ █ █ ███ ███ █ ███ █ █ █████████ ███ ███ ███ █████
█       █     █ █       █     █           █         █     █     █ █     █   █           █           █
█████████████████████████████████████████████████████████████████████████████████████████████████████
