111111111111111111111111111111111111111111111111111
100000100000000000000000000000100010000000000000001
101011101111111111111111111110101010111111111111101
101000001000000010000010000010001010100000000010001
101111111011111011101011101111111010111111101010101
101000000000100010001000100010001000000000001010101
101111101110101110111110111010101110111111101110101
100000100010101000100000100010100010100010001000101
111110111110101010111110101010111011101010111011101
100000100010100010100010001010001000001010100010001
101111101010111011101011111011101111111010101111111
100000101000100010001000101000100000001010100000001
111110101111111110111110101110111111101011111111101
100000101000000000000010100000100000101000000000101
101111101011111011111110101111111010101111111110101
100010000010001010001000100000000010101000000010001
111011111110101110101011111111111110101011111011101
100010000000100000100010001000001000100010001000101
101110111111111111111110101011101011111111101110101
101000101000001000000000100010001000001000001000101
101110101010111011111011111110111111101010111011111
100000100010100010001010000010100010001010001000001
111111101110101110101011111010111010111111101111101
100000101010001000101000001010001010100000101000001
111110101011111111101111101011101010101110101011101
100000101000100000001000001000000010001010101000101
101111101010101011101010111111111111111010101110111
100010001010001010001010100000000010001000100010001
111010111011111010111011101111111010101011101111101
100010101010001010001010001000001000101000000010001
101110101010101011111010111110101111101111101010111
100000100010101010000010000000100000100000101010001
101111101110101010111111111111111110111110101011101
100010001000100010000000000000000010100010001000001
111010111011111011111111111011111110111011111111111
100010001010100010000000100010000000100000000000001
101111111010101110111011101110111111101111111111101
101000100010000010101010001000101000001000000000101
101010101111111010101010111011101011101011111110101
100010100010001000101010000010001000101010100010101
111110111010101111101011111111101110101010101010111
100010001000100010001010001000000010100000101010001
101011101111101010111010101010111110111111101010101
101000100000101010001000101010001000101000001010101
111011111110111010101111101111101011101011111010101
100010000010001010100000100000100000001010000010101
101110111011101010101111111110111110111010111110101
101000100000100010101000000010000010100010000010101
101011101111111110101010111111111011101111111011101
100000100000000000100010000000000000001000000000001
111111111111111111111111111111111111111111111111111
