██████████████████████████████████████████████████████████████████████████████████████████████████████
██  ██                                  ██              ██                  ██                      ██
██  ██  ██████████████  ██████████  ██  ██  ██████  ██████  ██████████████  ██  ██████████████  ██  ██
██  ██      ██      ██  ██      ██  ██  ██      ██  ██      ██              ██  ██  ██          ██  ██
██  ██  ██████  ██  ██████  ██  ██  ██  ██████  ██  ██  ██████  ██████  ██████  ██  ██  ██████████  ██
██  ██  ██      ██          ██      ██      ██  ██          ██      ██  ██      ██  ██  ██          ██
██  ██  ██  ██████████████████████  ██████████  ██████████████████  ██████  ██████  ██  ██████████  ██
██      ██      ██              ██  ██          ██      ██          ██      ██      ██          ██  ██
██  ██████████  ██  ██████  ██  ██  ██  ██████████  ██  ██  ██████████  ██████  ██  ██████████  ██  ██
██          ██  ██  ██      ██  ██  ██          ██  ██      ██          ██  ██  ██          ██  ██  ██
██████████  ██  ██  ██  ██████████  ██████████  ██  ██████  ██  ██████████  ██  ██████  ██████  ██  ██
██          ██  ██  ██              ██      ██  ██      ██  ██  ██                  ██  ██      ██  ██
██  ██████████  ██  ██████████████████  ██  ██  ██████  ██████  ██████  ██████████████  ██  ██████  ██
██          ██  ██  ██                  ██  ██      ██      ██      ██  ██              ██  ██  ██  ██
██  ██████████  ██  ██████  ██  ██████████  ██████  ██████  ██████  ██████  ██████  ██████  ██  ██  ██
██  ██      ██  ██      ██  ██      ██  ██  ██          ██      ██          ██      ██      ██  ██  ██
██  ██  ██  ██  ██████  ██████████  ██  ██  ██  ██████████████  ██████████████  ██████  ██████  ██  ██
██  ██  ██  ██      ██              ██  ██  ██      ██          ██          ██  ██      ██  ██      ██
██████  ██  ██████  ██████████████████  ██  ██████  ██  ██████  ██  ██  ██  ██  ██  ██████  ██  ██████
██      ██          ██              ██      ██  ██  ██  ██  ██  ██  ██  ██  ██  ██      ██      ██  ██
██  ██████████████████  ██████  ██████  ██████  ██  ██  ██  ██  ██████  ██  ██  ██████  ██  ██████  ██
██  ██      ██      ██  ██  ██      ██  ██      ██  ██  ██              ██  ██  ██      ██  ██      ██
██  ██████  ██  ██  ██  ██  ██████  ██  ██  ██████  ██  ██████████████████████  ██  ██████  ██████  ██
██      ██  ██  ██              ██          ██      ██              ██          ██  ██  ██  ██      ██
██  ██  ██  ██  ██████████████████████████  ██  ██████████████████  ██  ██████████  ██  ██  ██  ██  ██
██  ██  ██      ██      ██              ██  ██  ██      ██      ██          ██      ██      ██  ██  ██
██  ██  ██████████  ██  ██  ██████████  ██████  ██  ██  ██  ██  ██████████████  ██████  ██████  ██  ██
██  ██              ██      ██      ██              ██      ██  ██              ██          ██  ██  ██
██  ██████████████████████████  ██████████████████████████████  ██  ██████████████████████  ██  ██  ██
██      ██  ██              ██                  ██          ██  ██                      ██  ██  ██  ██
██████  ██  ██  ██████  ██  ██████████  ██████  ██  ██████  ██████████████████████  ██  ██  ██  ██  ██
██      ██      ██      ██              ██      ██  ██              ██          ██  ██  ██      ██  ██
██  ██████  ██████  ██████████████████████  ██████  ██████████████  ██  ██████  ██  ██  ██████████  ██
██  ██          ██          ██          ██  ██  ██      ██          ██  ██      ██  ██          ██  ██
██  ██████████████████  ██  ██████  ██  ██  ██  ██████  ██  ██████████  ██████  ██████████  ██  ██████
██                  ██  ██      ██  ██              ██  ██          ██      ██          ██  ██      ██
██████████████████  ██████████  ██  ██████████████████  ██████████  ██████  ██████████  ██████  ██  ██
██          ██      ██          ██  ██              ██  ██      ██          ██      ██      ██  ██  ██
██  ██████████  ██████  ██████████████  ██████████  ██  ██  ██  ██████████████  ██████████  ██████  ██
██          ██  ██                  ██  ██              ██  ██  ██          ██          ██          ██
██████████  ██  ██  ██████████████  ██  ██████████████████  ██  ██  ██  ██████  ██████  ██████████  ██
██      ██  ██  ██      ██      ██  ██          ██          ██  ██  ██          ██      ██          ██
██  ██  ██  ██  ██████  ██  ██████  ██████████  ██  ██████████  ██████  ██████████  ██  ██  ██████████
██  ██      ██      ██      ██              ██  ██  ██      ██      ██  ██          ██  ██  ██      ██
██  ██████  ██████  ██████  ██  ██████  ██████  ██  ██████  ██████  ██████  ██████████  ██  ██████  ██
██      ██      ██  ██      ██  ██      ██      ██              ██      ██  ██      ██  ██          ██
██  ██  ██  ██████  ██████████  ██████████  ██████████  ██████████  ██  ██  ██  ██  ██  ██████████  ██
██  ██  ██  ██      ██      ██          ██          ██  ██          ██  ██      ██  ██  ██          ██
██  ██  ██████  ██████  ██  ██████████  ██████████  ██  ██  ██████████  ██  ██████  ██████  ██████████
██  ██                  ██                      ██      ██              ██      ██                  ██
██████████████████████████████████████████████████████████████████████████████████████████████████████
