██████████████████████
██          ██      ██
██  ██████  ██████  ██
██      ██      ██  ██
██  ██  ██████  ██  ██
██  ██          ██  ██
██  ██████████████  ██
██  ██              ██
██  ██████  ██████  ██
██          ██      ██
██████████████████████
