█████████████████████████████████████████████████████████████████████████████████████████████████████
█   █           █         █       █ █       █                   █             █         █           █
███ █ █████ ███ █ ███████ █ █████ █ █ ███ ███ ███████ █ █ █████ █ ███████ ███ █ █ █████ █████████ █ █
█   █ █ █   █ █   █     █ █ █ █   █ █ █   █   █     █ █ █ █   █ █ █     █   █ █ █   █ █ █       █ █ █
█ ███ █ █ ███ █████████ █ █ █ █ ███ █ █ ███ ███ ███ ███ ███ █ ███ █ ███ ███ █ █ ███ █ █ █ █████ █ █ █
█       █   █           █   █ █ █     █     █   █     █     █ █   █ █ █     █ █ █ █ █ █   █   █ █ █ █
███████████ █████ █████ █████ █ ███████████ █ ███████ █████ █ █ ███ █ ███████ █ █ █ █ █████ █ █ ███ █
█         █     █ █ █   █     █           █ █       █     █ █   █   █       █ █   █ █   █   █   █   █
█ ███████ █████ █ █ █ ███████ ███████████ █████ ███ █████ █ █████ █████ █ ███ ███ █ █ █ █ ███████ ███
█ █     █       █ █               █     █     █ █   █   █ █   █ █   █   █ █   █   █ █ █   █     █   █
█ █ █████████████ ███████████ █████ ███ █████ █ █ ███ █ █ ███ █ ███ █ █████ ███████ █████ ███ █ ███ █
█ █   █       █       █     █ █     █       █ █ █ █   █ █   █ █   █ █   █   █     █     █     █     █
█ ███ █ █ ███ █ █████ █ ███ ███ █████ █████ █ ███ █████ ███ █ █ ███ █ █ █ ███ ███ █████ ███████████ █
█   █   █   █ █ █   █   █   █       █ █     █     █     █   █   █   █ █ █ █   █   █   █ █   █     █ █
█ █ █ █████ ███ █ ███████ █ █ ███████ █ ███████████ ███ █ █████ █ ███ █ █ ███ █ ███ █ █ █ ███ ███ █ █
█ █ █   █   █   █       █ █ █   █   █ █   █ █   █   █   █   █   █ █ █ █   █   █     █   █     █   █ █
███ █ ███ █ █ ███ █████ █ ███ ███ █ █ ███ █ █ █ █ █ ███████ █████ █ █ █████ █████████████ █████ █ █ █
█   █ █   █ █ █       █ █     █   █   █ █ █   █ █ █ █   █   █     █   █     █       █   █   █   █ █ █
█ ███ █ █████ █████████ ███████ ███████ █ █ ███ █ █ █ █ █ ███ █████ █████ ███████ █ █ █ █████ █ ███ █
█ █   █   █   █         █   █   █       █ █   █   █ █ █ █ █   █   █ █     █       █   █       █ █   █
█ █ █████ █ ███ ███████ █ █ █ ███ █████ █ ███ █████ █ █ █ █ █ █ █ █ █ █ ███ ███████████████████ █ ███
█ █ █     █     █     █ █ █ █ █   █   █ █ █   █     █ █ █ █ █ █ █   █ █ █   █       █   █   █   █   █
█ ███ ███ ███████ ███ █ █ █ █ █ ███ █ ███ ███ █ ███ █ █ █ ███ █ ███████ █ ███ ███ █ █ █ █ █ █ █████ █
█   █ █     █     █   █ █ █ █ █     █   █   █ █ █ █ █ █   █   █     █   █   █   █ █ █ █   █   █ █   █
███ █ █████ █ █████ █ █ █ █ █ █████████ ███ ███ █ █ █ █████ ███████ █ █████ ███ █ ███ █████████ █ ███
█   █     █ █   █   █ █ █ █ █   █     █   █ █   █   █       █     █   █   █ █   █     █         █   █
█ █████ █ █████ █ █████ ███ ███ █ ███ ███ █ █ ███████████████ ███ █████ █ █ █ █████████ ███████ ███ █
█     █ █       █ █     █     █   █ █   █     █           █ █ █ █       █   █     █   █ █   █ █   █ █
█████ █ █████████ █ █████ ███ █████ ███ ███████ █████ ███ █ █ █ █████ ███████████ █ █ █ █ █ █ ███ █ █
█     █   █     █   █     █ █   █     █       █   █   █   █ █ █     █         █     █   █ █ █     █ █
█ ███████ █████ █████ ███ █ ███ █ █ █ ███████ ███ █ █████ █ █ █ █ ███████████ █████████ █ █ ███████ █
█ █   █             █ █   █   █ █ █ █   █     █   █     █   █ █ █           █       █   █ █         █
█ █ █ █ ███████████ █ █ ███ █ █ ███ █████ ███ █ ███████ ███ █ █████████ ███████████ █████ ███████████
█ █ █     █   █     █ █ █   █       █   █ █ █ █   █   █   █ █         █ █     █   █       █         █
█ █ ███████ █ ███ █████ █ ███████████ █ █ █ █ ███ █ █ ███ ███████████ █ █ █ █ █ █ ███████████ █████ █
█ █ █   █   █   █       █ █   █     █ █ █ █     █   █   █           █ █   █ █ █ █ █         █ █   █ █
█ █ ███ █ █████ █████████ ███ █ ███ █ █ █ █ ███████████ ███ █████████ █████ █ █ █ █ █████ █ █ █ ███ █
█ █     █ █   █   █     █     █ █     █   █ █     █   █ █ █ █   █     █     █ █ █ █     █ █   █   █ █
█ █████ █ ███ ███ ███ █ █████ █ █████████ ███ █ ███ █ █ █ █ █ █ █ █████ █████ █ ███████ █ █████ █ █ █
█ █     █ █     █   █ █     █ █     █     █   █     █ █ █ █   █   █ █   █     █       █ █   █   █   █
█ █████ █ █ ███ ███ █ ███████ █████ ███████ █████████ █ █ █████████ █ █ █ ███████ ███ █ ███ ███ █████
█     █ █   █   █   █         █         █   █     █   █ █         █   █ █   █   █ █ █ █ █ █   █ █   █
█████ █ █████ ███ █████████████ ███ ███ █ ███ ███ █ █ █ █ ███ ███ █ ███ ███ █ █ █ █ █ █ █ ███ █ ███ █
█     █ █     █   █     █   █   █   █   █   █   █   █ █ █   █   █ █   █   █   █ █ █ █ █   █ █ █   █ █
█ ███████ █████ ███ ███ █ █ █ ███████ ███ █████ █ █████ ███ ███ █ ███ ███ █████ █ █ █ ███ █ █ ███ █ █
█     █   █   █ █   █ █   █   █       █   █     █ █   █   █ █   █   █   █ █   █ █   █       █ █   █ █
█ ███ █ ███ █ █ █ ███ █████████ █ █████ ███ ███████ █ ███ ███ █████ █████ █ █ █ █████████████ █ ███ █
█ █ █ █   █ █ █ █   █           █ █     █   █       █     █   █     █   █ █ █ █           █   █   █ █
█ █ █ ███ ███ █ ███ █ █████████ ███ █████ ███ █████████████ ███ █████ █ █ █ █ ███████████ █ █████ █ █
█   █         █     █         █         █                   █         █   █ █               █       █
█████████████████████████████████████████████████████████████████████████████████████████████████████
