111111111111111111111111111111111111111111111111111
100010000000000000100000001000100010000000000010001
101010111111101111101011101010101110111111101110101
101010100000100000001010100010100010100000100000101
101010101010111111111010111110101010111010111111101
101010101010100000100010100000101000000010100010001
111010111010101111101110101111111111111110101010111
100010001010001000001000100000000000001000101010001
101111101011101011111110111111111111101011111011101
100000000010001010000000100000100000001000000010101
101111111111111010111011101110101111111111111010101
101000000000100010001000100010001000001000001010101
111011111110101111111110111011111110111010111010101
100010001000001000000010001010000010000010000010101
101110101111111011111010111010101010111111111110101
100010100000000010000010000010101010100010000000101
111010111111111110111011111011101010101011111110101
101000100000000010100010001000001010101000100010101
101111101111111010101110101111111010101110101010101
100000100000100010100010100000100010001000101000101
101111111110101010111010111110101111111011101011101
100000000000101010001010001010100010001000001010001
101111111111101111101111101010111011101110111110111
101000100000100000100000101010001000100010100010001
101010101011111110111011101011101110101110101011101
100010001010000000101000001010001010101000101000101
111111111110111110101111111010111010101011101110101
100010000010100010000000000010001000101010001010001
101010111010101010111111111111101011101010111011101
101000101000101000100010000000101010000010100000101
101111101111101111101010111110101011111110101011101
100010000000100000101010000010001000000010101000101
101010111011111110101010111011111111111010101110101
101010001000000010101010100010000000100010100010001
101011101111101110101010101111111010101110111111101
101010101000001000101010100000001010001000100000101
111010101011111011101011111011101011111010101110101
100010001000000010101000001010001000100010101000101
101111111111111010101111101110111110101110101011101
100000001000001000101000100000100010100010101000101
101111101011101111101110111110101010111110101110101
101000100010100000100010000000101010100010001000101
101010111110111110111011111110101010101010111011101
100010000010001000001000000010101000101010101010001
111111111011101011111111111011101011101010101011111
100000100000001010001000001000001010001010001000001
101111101111111010101011101111111010111011111111101
101000001010000010101000100010001000101000000010001
101011111010111110101110111010101111101111111010101
100000000010000000100000001000100000000000000000101
111111111111111111111111111111111111111111111111111
