11111111111
10000000001
10111111101
10100000101
10101110111
10101010001
10101011101
10100000101
10111010101
10000010001
11111111111
