111111111111111111111111111111111111111111111111111
100000101000001010100010000000101010000000000010101
101110101111101010101011101010101010111111111010101
101010000010000000001010101010100010100000100010001
111010101111101010101110101010111010111011111111101
100000100010101010101000001010000010001010000010001
101011111010111110111011111111101110111010111010111
101010000010000000000000001000101000000000101000001
101111111110101111111110111110111011101110101010101
100010001000101010101010001000100000100010100010101
111010111011101010101011101110101111111110111110101
100000000000101010000010100000001010000000100000101
101111101010101011111010111011111011101011111111101
101000001010101010001000001000000010001000000000101
111110111010101010111110111011111110101111111111111
100010001010101000001010000000001000101000100010001
101011111110101010101011111111101110101011111011101
101010001010101010101000100010001000101000000000001
101010111011101011111110111011101111111110101111111
101000000000001000000000000000001000000000101000001
101110111110101011111011101011111011111011101010111
100010100000101010001000101010001000101000100010001
111011111110101110101011101010101110101111101110111
100000001010101000100000101010101010001000101000001
111011111010111111101110101011101010101011111011111
100010100000001000100010101000100000101000001000001
111010111111101110101111111010101110111110111110111
100000100010001000001010101010100010100000000010001
101111111010101111111010101110111110111110101010111
101000100000100000100010001000100000000010101000101
101010111111101110111010111010101110111110101110101
101010001000100010001010101010000010100010101000001
101011101110101110111010101110111110111011111111111
100000100010100010000010001010100010101000000010001
101010111110111110111010111010101011101110111011101
101010001000100010100000001010001000100010100000001
101011101010111011101011111011111010101110111111111
101000100010001000001010001000100010100010100000001
101011111010111110101010111110111111111010101110101
101010001010100000101000000000001010000010001000101
111110111011111010101110111010111010101111101111111
100000000010001010100010100010100000100010000010001
111010111010111110111011111010111011101110111011101
100010100000001010001000101010000010100010100000001
111010111111111010111110101011101010101110111011111
100010100000101000000010001010001010000000001010001
111111101110101110111110111010101111111011101010101
100000001010000000001010101010100010000000101000101
101110101011101011111011101010111111111110111010101
100010101000001000000000001010000000001000001010101
111111111111111111111111111111111111111111111111111
