█████████████████████████████████████████████████████████████████████████████████████████████████████
█             █   █         █ █ █ █ █ █   █ █     █   █ █ █ █ █ █     █         █     █         █   █
███ █ █ ███ ███ █ ███ ███ ███ █ █ █ █ ███ █ █ █ █ █ ███ █ █ █ █ █ █████████ ███ █████ █ █████ █████ █
█   █ █ █   █   █ █     █   █ █ █       █ █ █ █ █ █   █     █     █   █       █ █   █       █ █     █
███████ ███ █ █ █ █ █████ ███ █ █ ███ ███ █ ███ ███ █ █ ███ █ ███ ███ ███ █ ███ █ █ █████ ███ █████ █
█     █   █ █ █ █ █ █   █           █ █           █ █   █     █   █     █ █ █   █ █ █ █     █   █   █
█ ███████ █████ █ █ █ █ ███ █ ███████ ███ █ █████ █████████ █ █ █ █ ███ ███ █ █████ █ ███ ███ ███ █ █
█ █     █ █ █   █   █ █ █ █ █     █       █ █       █ █ █   █ █ █   █ █     █ █     █ █   █       █ █
█ █████ █ █ █████ █████ █ █ █████████ ███████ ███ ███ █ ███████ █████ █ ███ ███ █ █ █ █ ███████ █ ███
█               █   █   █   █ █ █   █       █   █ █ █         █   █   █   █ █ █ █ █       █ █   █   █
███████ █████ ███ ███ █ █ █ █ █ ███ ███ ███ ███████ ███████ ███ ███ ███ █ ███ █ █ ███ █████ ███ █ ███
█   █ █     █ █   █   █ █ █ █         █   █   █   █       █     █   █ █ █   █   █   █     █     █ █ █
███ █ █ █████████████ ███ █ █ ███ █████████ ███ █████████ █ ███ ███ █ ███ ███ █ ███ █ ███ █████████ █
█   █     █   █ █   █ █ █ █ █ █       █     █ █   █ █ █ █ █   █ █   █ █ █     █   █ █ █   █ █       █
███ █ █████ ███ ███ █ █ █ █████ ███ ███████ █ █ ███ █ █ █ █ ███ █ ███ █ ███ █ ███ █ █████ █ █████ █ █
█   █     █       █   █   █ █     █   █       █     █     █ █   █     █     █   █ █   █         █ █ █
█ ███ █ ███ █████ █ █ █████ █ █████████ █ ███ █████ █ █████ █ █ ███ █████ █████ ███████ █ ███████ ███
█     █ █ █ █   █ █ █ █   █ █     █   █ █   █       █     █ █ █       █     █     █ █ █ █ █ █ █ █ █ █
█ █████ █ ███ ███ █ ███ ███ █ ███████ ███ █ █████ █ █ █ █ █ ███████ █ █████ █ █ ███ █ █████ █ █ █ █ █
█ █         █   █   █ █   █ █       █ █ █ █ █     █ █ █ █     █ █ █ █   █   █ █ █ █                 █
█████████ ███ ███ ███ █ █ █ █ █ █████ █ █████ █ █████ █ █ █ ███ █ █████ ███ █████ █████ ███ ███████ █
█   █   █   █ █   █ █   █ █   █ █ █   █ █ █   █   █ █ █ █ █       █     █         █   █   █ █     █ █
███ ███ ███ █ ███ █ █ █ ███ ███ █ █ █ █ █ ███ █ █ █ ███████████████████████ █████ █ █████ ███ █ █ ███
█ █       █   █       █ █     █   █ █         █ █     █         █     █     █     █     █ █   █ █ █ █
█ █████ █████ █ █ █████ █ ███████ █ █████████ █████████ █████ █ █████ █ ███ █████ █ █████ █████ ███ █
█           █ █ █ █             █ █     █   █     █ █   █ █   █   █   █   █   █ █       █         █ █
█ █ ███ ███ █ █ █ █████ ███ ███ ███ █████ ███ █ ███ ███ █ ███ █████ █ █ ███████ █ █████ █ ███ ███ █ █
█ █   █ █   █   █   █     █ █     █       █   █           █   █   █ █     █ █ █   █       █   █   █ █
█ █ ███████ █ █████████ █████ █ ███████ █████ █████ █ █ █ █ ███ ███ █████ █ █ ███ ███ ███████ ███ █ █
█ █   █         █     █   █   █ █ █       █ █   █   █ █ █ █   █   █     █   █     █   █       █     █
███ ███ █████████ ███ █ █████████ ███████ █ █ █ █████ █ █ █ █ █ ███ █ ███ █████ █████████ █ █ ███ █ █
█   █     █ █ █   █ █ █       █       █ █ █ █ █   █   █ █ █ █     █ █   █ █             █ █ █ █ █ █ █
█████ █ █ █ █ ███ █ █ █ █████████ █ ███ ███ ███████ █████████ █████ █ ███ ███ █ ███████████ ███ █████
█     █ █         █ █ █ █   █ █ █ █     █ █ █     █ █   █           █   █ █   █   █ █             █ █
█ █████ ███ ███ ███ ███ █ █ █ █ █ █ █████ █ █ ███ █ █ █ █████ █████ ███████ ███ ███ ███ █████ █████ █
█     █   █ █   █     █ █ █   █   █ █ █ █ █ █ █ █ █   █   █     █     █       █ █       █   █       █
█████████ ███ █ █ █████ █████ █████ █ █ █ █ ███ █ █ █ █ █████████████████ ███ █████ █ █ █ ███ █ █████
█ █ █       █ █ █     █     █   █ █ █ █ █   █ █ █   █ █   █     █         █       █ █ █     █ █     █
█ █ █ ███████ █ █ ███ █ ███ █ █ █ █ █ █ ███ █ █ █████ ███ █████ ███ █████ █████ █ █████ █ █████ █ █ █
█     █   █   █   █ █ █ █     █   █ █ █   █     █ █   █   █   █         █ █     █   █ █ █   █ █ █ █ █
█ ███ █ ███████ ███ █████ █████████ █ ███ █ █ ███ █████ █████ █████ █████ ███ ███████ █████ █ ███████
█   █     █           █ █     █   █ █ █   █ █         █   █ █     █ █       █   █   █ █             █
███ ███████ █ █████ █ █ ███ █ ███ █ █ ███ █ ███ ███ █████ █ █ █ █████████ █ ███████ █ ███████ ███ ███
█   █       █     █ █   █ █ █               █ █ █ █ █       █ █     █   █ █ █           █   █   █ █ █
█ ███████ █ █ ███████ ███ █ ███████ █████ █ █ ███ ███ █████████ █ ███ █████ ███████ █ █████ █ █████ █
█ █   █   █ █       █ █ █ █ █     █   █   █   █ █       █     █ █     █   █ █ █ █   █ █     █   █   █
█████ █ ███ █████ █ █ █ █ █ █████ █ ███████ █ █ █████ ███ ███ █ ███ █ █ █ █ █ █ ███ ███ ███████ █ █ █
█ █       █ █ █   █ █     █ █ █           █ █           █   █ █ █ █ █ █ █       █         █ █ █ █ █ █
█ █ ███ █████ █ ███ █ ███ ███ █ █ █ ███ ███ ███ █ █████ █ ███ ███ █ █ ███ █████ █ █ ███ ███ █ █ █ █ █
█   █     █       █ █   █ █     █ █ █     █   █ █ █       █     █   █     █       █ █   █         █ █
█████████████████████████████████████████████████████████████████████████████████████████████████████
