██████████████████████████████████████████████████████████████████████████████████████████████████████
██      ██      ██  ██          ██              ██          ██  ██  ██  ██  ██      ██  ██      ██  ██
██  ██  ██  ██  ██  ██████████  ██████  ██████████████████  ██  ██  ██  ██  ██████  ██  ██████  ██  ██
██  ██      ██          ██  ██  ██              ██      ██  ██  ██              ██                  ██
██  ██████████████  ██████  ██  ██  ██  ██  ██  ██  ██████  ██  ██  ██████  ██████████  ██████████████
██          ██  ██          ██      ██  ██  ██      ██                  ██  ██  ██  ██              ██
██████  ██  ██  ██  ██████████  ██████████  ██████████  ██████████  ██████  ██  ██  ██  ██████████  ██
██  ██  ██  ██  ██                      ██  ██                  ██  ██                  ██  ██  ██  ██
██  ██████████  ██  ██████████  ██████████  ██████████  ██  ██  ██████████████████  ██████  ██  ██  ██
██  ██                  ██              ██      ██      ██  ██  ██          ██      ██      ██      ██
██  ██  ██████████  ██  ██████  ██████████████████████████████████████  ██████████████  ██████  ██████
██          ██  ██  ██  ██          ██                  ██  ██              ██  ██                  ██
██  ██  ██████  ██████  ██  ██████████  ██████████████████  ██████  ██████████  ██████████  ██████████
██  ██      ██          ██              ██  ██  ██      ██          ██      ██  ██  ██  ██      ██  ██
██████████  ██████████████████  ██████  ██  ██  ██  ██████████  ██  ██████  ██  ██  ██  ██████  ██  ██
██              ██  ██  ██          ██          ██      ██  ██  ██  ██              ██          ██  ██
██████████  ██  ██  ██  ██████████  ██  ██████████  ██████  ██████  ██  ██  ██████████  ██████  ██  ██
██          ██          ██          ██                  ██              ██  ██  ██  ██  ██          ██
██████████  ██████  ██████  ██████  ██  ██  ██  ██████████████  ██████  ██  ██  ██  ██  ██  ██████  ██
██      ██  ██          ██      ██  ██  ██  ██      ██          ██      ██  ██  ██      ██  ██  ██  ██
██  ██████████  ██████  ██  ██████  ██████  ██  ██████████████  ██████████  ██  ██████████  ██  ██████
██  ██  ██          ██  ██  ██      ██      ██  ██                      ██      ██  ██      ██  ██  ██
██  ██  ██████████  ██████████████████████  ██  ██  ██████████  ██  ██████████████  ██  ██████  ██  ██
██          ██              ██  ██          ██          ██      ██      ██  ██      ██              ██
██  ██████████  ██  ██████████  ██  ██████  ██████████████  ██████████  ██  ██████  ██  ██  ██  ██  ██
██          ██  ██  ██  ██          ██              ██  ██      ██  ██              ██  ██  ██  ██  ██
██  ██████████  ██████  ██████████  ██████  ██  ██████  ██  ██████  ██████  ██████  ██  ██████████  ██
██      ██      ██      ██  ██          ██  ██      ██  ██          ██      ██          ██          ██
██████  ██████████  ██████  ██████  ██████████████████  ██  ██████████████████████████████████  ██  ██
██                  ██      ██  ██          ██  ██  ██  ██  ██                  ██  ██  ██      ██  ██
██  ██  ██████████████  ██  ██  ██  ██████████  ██  ██  ██  ██████  ██████████  ██  ██  ██████████  ██
██  ██          ██  ██  ██          ██  ██              ██      ██          ██          ██          ██
██  ██████  ██████  ██  ██████████████  ██████  ██████████  ██  ██  ██████████████  ██████████  ██  ██
██  ██                      ██  ██      ██                  ██  ██  ██                  ██  ██  ██  ██
██  ██████  ██████  ██████████  ██  ██████████  ██  ██████  ██  ██████████████████  ██████  ██████  ██
██      ██  ██          ██      ██  ██      ██  ██      ██  ██      ██  ██      ██  ██  ██          ██
██████  ██████  ██████████  ██████  ██  ██████  ██  ██  ██  ██████████  ██████  ██  ██  ██████  ██████
██      ██                              ██  ██  ██  ██  ██              ██                  ██      ██
██████████████  ██████  ██████████  ██████  ██  ██████████████████  ██████████  ██████████████  ██████
██      ██          ██  ██          ██                  ██              ██  ██      ██  ██  ██  ██  ██
██████  ██████████████████████████████████████████  ██  ██████  ██  ██  ██  ██  ██  ██  ██  ██  ██  ██
██              ██          ██                      ██  ██      ██  ██  ██      ██  ██              ██
██  ██  ██  ██████  ██  ██████████████  ██  ██████████  ██  ██████████████████  ██  ██████████  ██████
██  ██  ██          ██  ██              ██  ██      ██  ██  ██  ██      ██      ██                  ██
██  ██████  ██████████  ██████████████████  ██████  ██████  ██  ██  ██████████  ██  ██████████  ██  ██
██  ██              ██                      ██      ██                  ██      ██  ██      ██  ██  ██
██  ██  ██████████  ██████████████  ██  ██████  ██  ██  ██  ██████████  ██████████████  ██████████  ██
██  ██          ██  ██              ██  ██  ██  ██  ██  ██          ██      ██                      ██
██  ██████████████  ██  ██  ██  ██████  ██  ██████  ██  ██  ██  ██████████  ██████  ██  ██  ██  ██  ██
██              ██  ██  ██  ██      ██      ██          ██  ██      ██          ██  ██  ██  ██  ██  ██
██████████████████████████████████████████████████████████████████████████████████████████████████████
