11111111111
10101010101
10101010101
10000010101
10111110101
10000010001
11101111101
10000000101
11111010101
10000010001
11111111111
