██████████████████████
██          ██      ██
██████████  ██  ██████
██          ██      ██
██  ██████  ██████  ██
██  ██      ██      ██
██  ██████  ██  ██  ██
██  ██  ██      ██  ██
██  ██  ██████  ██████
██  ██              ██
██████████████████████
