11111111111
10001000001
11101111101
10000010101
11101110101
10100000101
10111010101
10000010001
11111011111
10000000001
11111111111
