111111111111111111111111111111111111111111111111111
100010000000001000000000000000100000000000000010001
111011111111101111111111101010111110101011101110111
100000001010101000100000001010000000101010100000101
101011101010101110101111111111101110101110101111101
101010001000101000101000001010000010101000101000001
101011101110101110111111101011101111111010111011111
101010000000000000000000101000000010000010101000101
111111111011111111111110101010111010111110101011101
100000000010000000000000000010001010000010100000001
111110101111111011111111111110101110111111101110111
101000101000000010000000001010100000000000001000001
101110111110111111111111101010111110111010101111111
101010100010100000000000000000100000001010100010101
101011111011111011101111101111101110101110101010101
100000101000100010001000001000000010100010101000001
111011101110111110101011111110111011111110111010101
100010100000100000101010000000101000000010100010101
111010101110111111111110111110101011111110101011111
101000101000101000000010100000100000000010101000001
101110111110101111101111111010101011101111111110101
100000000010000000000000000010101000100010100000101
101110111011111111111111101110101111101110111110111
101000001000001000000000001000100000100000001000001
101110111110111110111110111110101011111011111011111
101000100000000010101000001000101000101000100000001
111010111011101110101110111111101110101110101010111
101010100010000000000010100000001000000010101010101
101011111010111011111110111011101010101011111010101
100010101010100000001000001000101010101000100010001
101010101110101110101010111111111011111111101111101
101010000000101010101010001010000000100000100010001
111010101110101011101110111011101011101111101011111
100010101000100010101010000010101000101000101000001
101010111110101110111010111010111010101011111111101
101010100000101000100010100010000010000000001010101
111011111110111110101110101011101110101110101010111
100010100010100000000000101010000010100010100000001
111010111010111111101111111011111010101011101111111
100010000000100000000010000010100010101000100000001
101111111110111111101110101110111110101110101011111
101000100000001000000010101000101000100010101010101
111110111010111011101011101110101110111011111010101
100000000010100010001010000010000000001000001000001
111011111011111010101010101111111010101111101011101
100000100000001010101010101010000010100000101000101
101010111011111011111011111011101110111110111011111
101010100000001010000010100000000010000010001000001
101011101111101010111110101011101111111010101010101
101010000010001010100000001000100000001010101010101
111111111111111111111111111111111111111111111111111
