██████████████████████████████████████████████████████████████████████████████████████████████████████
██  ██          ██              ██  ██  ██      ██      ██                  ██      ██      ██      ██
██  ██████  ██████████████  ██████  ██  ██  ██████████  ██  ██████████████████  ██████  ██████████  ██
██          ██  ██  ██      ██  ██      ██  ██  ██          ██          ██  ██  ██                  ██
██████  ██  ██  ██  ██████  ██  ██████  ██  ██  ██████████  ██  ██████████  ██  ██████  ██████████████
██      ██  ██          ██      ██  ██  ██      ██              ██  ██  ██                          ██
██  ██  ██  ██████  ██████  ██████  ██  ██████  ██████████  ██████  ██  ██████  ██████████████████████
██  ██  ██      ██  ██  ██          ██      ██          ██  ██  ██      ██  ██  ██  ██  ██  ██  ██  ██
██████████████  ██  ██  ██████████  ██████  ██  ██  ██████  ██  ██  ██  ██  ██  ██  ██  ██  ██  ██  ██
██                  ██      ██  ██      ██  ██  ██                  ██  ██                      ██  ██
██████  ██  ██████  ██████  ██  ██████  ██  ██████████████████  ██████████████  ██  ██  ██  ██████  ██
██  ██  ██  ██  ██  ██      ██      ██  ██                      ██  ██          ██  ██  ██  ██      ██
██  ██  ██  ██  ██  ██████  ██  ██████  ██████  ██████████████  ██  ██████████  ██████████████  ██  ██
██  ██  ██      ██                          ██  ██  ██                  ██  ██  ██  ██  ██      ██  ██
██  ██████████████████████████████  ██  ██████████  ██████████████████  ██  ██  ██  ██  ██  ██████████
██                      ██          ██  ██  ██      ██  ██                          ██  ██          ██
██████  ██████  ██████  ██████  ██████  ██  ██  ██████  ██████████  ██  ██  ██  ██████  ██  ██████  ██
██      ██      ██              ██                          ██  ██  ██  ██  ██                  ██  ██
██  ██  ██  ██████████  ██████████████████  ██  ██  ██████████  ██████  ██  ██████████████████  ██████
██  ██  ██  ██              ██              ██  ██                      ██              ██  ██  ██  ██
██  ██████████████  ██  ██████████████  ██  ██  ██  ██  ██  ██████████  ██████  ██  ██████  ██████  ██
██              ██  ██  ██              ██  ██  ██  ██  ██          ██      ██  ██                  ██
██  ██  ██████████████  ██████████████████████  ██████  ██  ██████  ██████  ██  ██  ██████████  ██  ██
██  ██  ██  ██  ██  ██  ██              ██      ██  ██  ██  ██          ██  ██  ██      ██      ██  ██
██  ██████  ██  ██  ██████████████████  ██████████  ██  ██████████  ██  ██████████  ██████████  ██████
██      ██              ██  ██                  ██              ██  ██  ██      ██  ██  ██          ██
██████████████  ██████  ██  ██  ██████████████  ██████  ██████████████  ██████  ██████  ██████  ██████
██              ██  ██      ██  ██  ██                      ██      ██          ██      ██          ██
██████████████████  ██  ██  ██████  ██  ██████  ██  ██  ██  ██  ██████  ██████  ██  ██████  ██████  ██
██  ██                  ██              ██      ██  ██  ██          ██      ██      ██          ██  ██
██  ██████  ██████  ██████  ██████████████  ██  ██████████  ██████████████  ██████  ██  ██████  ██████
██  ██      ██      ██  ██  ██  ██          ██  ██                      ██      ██  ██  ██          ██
██  ██████  ██  ██████  ██████  ██████████████████████  ██  ██████  ██████████  ██  ██████  ██████  ██
██  ██  ██  ██  ██                  ██      ██  ██  ██  ██      ██  ██      ██  ██  ██  ██  ██      ██
██  ██  ██████████████  ██  ██████  ██  ██████  ██  ██████  ██████  ██  ██████████████  ██████  ██  ██
██                  ██  ██  ██                                  ██                      ██  ██  ██  ██
██████████  ██████  ██████████  ██████  ██████████████  ██  ██  ██████████  ██  ██  ██  ██  ██████████
██          ██                  ██          ██          ██  ██          ██  ██  ██  ██              ██
██████████████████████████  ██████  ██████████  ██████  ██████  ██  ██████████  ██████  ██  ██  ██  ██
██      ██      ██  ██  ██  ██  ██          ██      ██      ██  ██          ██      ██  ██  ██  ██  ██
██████  ██████  ██  ██  ██████  ██  ██████  ██  ██  ██  ██████████████████████  ██████████  ██  ██  ██
██                                      ██  ██  ██  ██                      ██          ██  ██  ██  ██
██████████  ██  ██████  ██  ██████  ██████  ██████  ██████████████  ██████  ██  ██  ██  ██  ██  ██████
██          ██  ██      ██  ██          ██  ██                  ██      ██  ██  ██  ██  ██  ██      ██
██████████████████  ██  ██████  ██  ██████  ██████  ██████  ██  ██████  ██████  ██████████  ██████████
██              ██  ██      ██  ██  ██  ██  ██      ██      ██      ██      ██          ██          ██
██  ██████  ██████████  ██  ██  ██  ██  ██████████  ██████  ██████████  ██████  ██  ██  ██  ██████  ██
██  ██                  ██  ██  ██      ██              ██      ██          ██  ██  ██  ██      ██  ██
██  ██  ██  ██████  ██  ██  ██  ██  ██████████████  ██████  ██  ██  ██████  ██████  ██████████████████
██  ██  ██  ██      ██  ██  ██  ██  ██              ██      ██  ██  ██          ██                  ██
██████████████████████████████████████████████████████████████████████████████████████████████████████
