█████████████████████████████████████████████████████████████████████████████████████████████████████
█     █   █           █ █   █   █ █     █   █ █       █   █   █   █ █ █             █ █ █ █         █
█████ █ ███ █████ ███ █ █ ███ ███ ███ ███ ███ █ █████ ███ █ ███ ███ █ ███ ███ ███████ █ █ █ █████████
█ █     █   █ █ █   █ █ █     █   █ █   █       █   █ █   █ █   █ █         █   █   █ █     █       █
█ █████ ███ █ █ ███████ █ ███████ █ █ ███ ███████ ███████ █ █ █ █ █ █████████ ███ ███ ███ ███ █████ █
█         █         █ █ █ █ █ █   █   █       █ █   █         █ █       █ █ █     █   █   █       █ █
███████ ███ ███ █████ █ █ █ █ ███ █ █████ █████ █ ███ █████ ███ ███ █ ███ █ █████ █ ███ ███ █████████
█ █ █     █ █     █       █     █ █             █       █     █ █   █         █       █ █   █ █ █ █ █
█ █ █ █████ ███████████ ███ █ ███ █████ █████████ █████████████████ ███ █████████ █████ █ ███ █ █ █ █
█   █       █   █   █     █ █   █   █ █   █     █ █     █   █   █     █   █ █   █ █       █   █     █
█ █ █████ █ █ ███ ███ ███████ █████ █ █ █████ █ █ █ ███████ ███ █ █ ███████ █ █████ █████ ███ █ ███ █
█ █ █     █   █ █         █ █   █ █           █     █         █   █   █ █ █ █ █ █ █     █       █   █
███ █████ █████ ███ ███████ ███ █ ███ █████████████ █ ███ █████ ███████ █ █ █ █ █ █ ███████ ███ █████
█ █   █       █ █     █   █ █         █         █       █         █ █                     █ █       █
█ ███ ███ ███ █ ███ ███ ███ █ ███ █ ███ ███ ███████ █ █ ███ █ █████ █ ███ ███████████ █████ ███ ███ █
█     █ █ █ █ █   █ █ █ █   █ █ █ █     █ █       █ █ █ █ █ █   █   █ █ █     █     █ █   █   █   █ █
█████ █ █ █ █████ █ █ █ █ █ █ █ █████████ ███████████████ █████████ █ █ ███████ █████ █ ███████ █████
█   █ █   █ █ █ █       █ █       █ █             █   █   █ █   █ █ █   █   █       █       █ █     █
███ █ ███ █ █ █ █ █████████ ███████ █ █████ █████████ ███ █ █ ███ █ ███ █ █ █ █████ ███ █ ███ ███████
█   █ █ █ █ █     █   █   █     █       █ █ █   █ █     █ █ █ █     █     █   █ █ █   █ █     █     █
███ █ █ █ █ █ █████ █████ ███ █████ █████ ███ ███ ███ ███ █ █ █████ ███ █ █ █ █ █ ███████████ █ █ ███
█ █   █ █ █         █       █     █   █     █   █   █ █ █ █ █ █         █ █ █   █ █   █ █   █   █   █
█ ███ █ █ ███ ███ ███ ███ ███ █████ █████ ███ ███ ███ █ █ █ █ ███ ███████████ ███ █ █ █ ███ █████████
█   █           █ █ █   █   █         █       █             █             █ █ █ █   █ █ █     █ █   █
███ ███ ███ ███ ███ █ █ █████ █████████ █ █████ ███████ █████ █████ ███ ███ ███ █ █████ █ █████ █ ███
█       █ █ █ █ █   █ █ █ █       █ █   █ █ █     █ █ █         █ █   █ █ █ █           █ █ █   █   █
█ ███████ █ █ █████ █ ███ ███ █████ █ █████ █ █████ █ █ █████ █ █ ███ █ █ █ █████ ███████ █ █ ███ █ █
█ █ █     █   █   █   █ █   █ █ █             █ █     █     █ █   █ █ █ █     █ █   █ █ █       █ █ █
███ █████ █ █ █ ███ ███ ███ █ █ █ ███ █████████ █ ███████ █████ █ █ ███ ███ ███ █ █ █ █ ███ █████ ███
█     █   █ █   █           █ █   █ █ █ █   █         █ █ █ █   █   █   █       █ █ █   █ █ █ █   █ █
█████ ███ █ ███████ █ ███ ███ █ ███ ███ ███ █ ███ █ ███ ███ ███████████████ █████ █████ █ █ █ ███ █ █
█     █       █     █   █                 █   █ █ █ █       █ █ █   █ █ █ █ █ █             █ █   █ █
███ █████████ █ ███ ███████ █████ ███ █████ ███ █████ █████ █ █ █ ███ █ █ █ █ █ ███████ █ ███ ███ █ █
█   █       █     █ █ █   █     █   █       █ █   █       █     █ █ █                 █ █     █   █ █
█ █ █████ █ █ ███████ █ █████ ███ █ ███ ███ █ █ ███ █████ ███████ █ █ ███████████ ███████ █ ███ ███ █
█ █       █               █ █ █ █ █   █   █   █ █ █     █               █   █   █ █     █ █ █   █   █
█ ███ ███ █ █████████ █████ ███ █████ █ █████ █ █ █ █████ █ █ █ █ ███ ███ ███ █████ ███████████ █ ███
█   █ █ █ █       █ █             █   █   █     █       █ █ █ █ █ █                         █   █   █
█ █████ █████ █████ █████████████ ███ █████ █ ███ ███████ ███ █ █ █ █ █ ███ ███ █ █████████████ █ ███
█ █ █ █                 █       █ █       █ █     █ █   █ █   █ █ █ █ █   █ █   █       █   █ █   █ █
███ █ ███ █ █ ███ ███ █ █ █████ ███████ ███████ █ █ █ █████ █ █ ███ █ ███ █ ███ █████ ███ ███ █ ███ █
█         █ █   █ █   █ █ █   █     █ █ █       █     █ █   █ █   █ █ █ █ █ █       █               █
███ █ █ █ █ █████ █ █ ███ ███ █████ █ ███ █ █ ███ █ ███ ███ ███████ █ █ █████ █████ ███████ █ ███████
█   █ █ █ █   █   █ █         █   █ █   █ █ █   █ █       █ █   █ █ █ █ █ █       █   █   █ █       █
███████ █ ███████ █████ ███ █ ███ ███ █ █████ █████████ █████ ███ █████ █ █ █ ███████████ █ ███ █ ███
█ █     █     █     █   █ █ █         █ █ █ █ █       █         █ █       █ █   █ █ █         █ █   █
█ █ █ █ ███████ █████ █ █ ███ █████ █████ █ ███ ███ █ █████████ █ █ ███████ ███ █ █ █ █ ███████ ███ █
█   █ █   █   █   █   █     █     █               █ █       █         █   █ █       █ █       █ █ █ █
█████ █ █ █ ███████ █ █ ███ ███ █ █ █ █ ███████ ███████ █ █████ █ ███ █ ███ █ █████ █ █ █ ███ █ █ █ █
█     █ █       █   █ █   █   █ █ █ █ █       █       █ █     █ █ █       █ █     █ █ █ █ █   █   █ █
█████████████████████████████████████████████████████████████████████████████████████████████████████
