111111111111111111111111111111111111111111111111111
101000101000101010000010101000101010001010001000101
101011101110101011101110101011101010111010111011101
100000100010101000000000000000101010000000101000101
101011111010101010101011101111101011101111101011101
101010101010000010101000100000101000101010101010001
111010101011101110111011101111101110101010101011101
100000000000001000101000101000100010101010000000001
101011101110101110101111111110101110101010111010111
101010000010101000000000101000000010000000001010101
111110101010111011101010101110111110111011101111101
100000101010001010001010101010000000001000100000001
111110111010111111111011101010111010111010101010101
100010100010000010000000000000001010001010101010101
111011111110101110101011111011101011111010101111111
101010100000101000101000001010001000001010100000001
101010101111101110101111101010111011111110111110101
100000001010101000100000101010001000001000001000101
111011101010101110111011111110111011111011101110111
100000100010001000001000101010001000101000101010001
111011101011111011111011101010111111101010111011111
100010001010000000100000100000000000001010000000101
111011101111101111101111101110111110111110111010101
100000100010001010000000101000000010100010100010001
111111101111111011101110111110101110111010111011101
101000001000000000000010100000100010100000001000101
101011101111101010101010101010111110111111101010101
100010000000101010101010101010000010000000101010101
101110111011111010111010111010111111101111111011101
100010100000100010001010100010100010000010000000101
101010111111111110111011111010101111111111101110101
101010000010101000001010000010000000001000101000101
111010101110101011111010101110101011111011101110101
100010101000000000100010100010101000101010101000101
101110101111111010101110101011111110101010111011101
101000101000000010101000101000100010100000001010001
101011101111101010111010111011101110101010111011101
101010001010101010001010100000000010001010100010001
111110111010111010111011101111101110111111111011101
100000100000000010001000100010001010101010001000101
111111101110111111111011101011101011101010111011101
100000000010001000000010001010001010000000001000101
101011111110111111101011101111101010111110111111101
101000100000000010001000100010000000000010000010001
101111111011101110111110101011101011101011111011101
101000001010001000001000101010001010101000001000101
111111101111101010111110101011101010111111101011101
100000101000001010100000101010001000000000101000101
111110101111101010111010101110111010111110101111101
100000000000001010001010101000100010001000100000101
111111111111111111111111111111111111111111111111111
