██████████████████████
██  ██  ██      ██  ██
██  ██  ██████  ██  ██
██  ██              ██
██  ██████████  ██████
██  ██              ██
██  ██  ██████████████
██                  ██
██████  ██████████  ██
██              ██  ██
██████████████████████
